0000C00000000000000000000000C00000000000000000000C0000000000000000000000000000000C00000000000000000C0000000000000000000000000000000C0000000C0000000000000;
000000000009000000000000000000000000000000000000000000000000C0000000000C00000000000000000000C0000000000C000000000000C00000000009900T00C000000000000000000;
0000000000030000000000000000000000000000C00000000000000000000000099C0000000000000000000000000000000000000000C0000000000000000000000F000000000000000000000;
00000000000000000000000000000000000000000000000000000000000000009009000000000000099000000000000000000009900000000000000000000440000F000000000000000000000;
00000000000000000000000000000000000000000000000000000000000000000000000000000000900900000999000000000090000000000000000000004440000F000000000000000000000;
00000000000000000000000000000000000000000000000000000000000000000000000999000000000000000000000000000000000000000000000000044440000F000000000000000000000;
00000030023232000000000000000000000056009990056000002332000000004004009000900000000000000333000000000000033356000000000000444440000F000000000000000000000;
00000000000000000000000000056000000078000000078000000000000000044004400000000005600000000000000000002220000078002200000004444440000F000000000000000000000;
00000000000000000560000000078000000078000000078000000000000000444004444000000007800056000000000005600000000078000000000044444440000F000000000000000000000;
0000B00000000000078000B0000780G000007800BGG0078000000000B0SS04444004444PP00000078000780S0PPP00B007800000000078PPPP00B0044444444000040000000B0000000000000;
111111111111111111111111111111111111111111111111111111111111111110011111111111111000111111111111111000000000111111111111111111111111111111111111111111111;

